X.................XX
X.X.X.XXXX.XX.XXX.XX
X.X.X....X..X.XXX..X
X.X.XXXX.XX.X..XXX.X
X.X.XXXX.XX.XX.XXX.X
.....*..............
.XXX.XXX.X.XX.XXX.XX
.XXX.XXX.X.XX.XXX.XX
.XXX..XX.X........XX
...XX.XX.X.XXXXXXXXX
XX....XX.X..........
XXXX.XxX.XXXXXXXXXX.
X........XXXXXXXXXX.
X.XX.XXX............
X.XX.XXXX.XXXXXXX.XX
X....XXX..X.X.X.X..X
X.XX.XXX.XX.X.X.XX.X
.......X..X........X
XXX.....X.XX.XX.XXXX
XXX.....0..........X
